moord	Moord
Moord	Moord
	Sy ly
Die woord wat jubelend deur die skepping skal wat elke smart en kommer stilmaak wat alle menseskuld verskoon Die ewige woord 	Watter woord
Waarom so n vraag	Wat ek wil hê
Vrede	geluk
Wat	Nee
Ek beter saamgaan	Ja
Goeie nag	Goeie nag Pa
En sê Hans moet strooi vir die merrie bring	Ja
En pasop vir die sonde	Ja Vader
Wat	Die Heer is met u
Wat sê jy	Hy het my geweier
Ek sien	Wel
O God	O God
Nee	Nee
Sal Oom my in die bed kom sit	Ja
Johannes	Johannes
Johannes	Johannes
Johannes	Johannes
Johannes	Johannes
Johannes	Johannes
Johannes	Johannes
Johannes	Johannes
Johannes	Johannes
Johannes	Johannes
Johannes	Johannes
Johannes	Johannes
Johannes	Johannes
Johannes	Johannes
Johannes	Johannes
Johannes	Johannes
Johannes	Johannes
Ja	Life
Laat Prinses Nene dadelik hierheen kom	Dit is wonderlik
Is Nene by Ma	Ja
Beter om een te veel rebel te vang as om een onskuldige vir n dag aan te hou	Ja Majoor
Is dit	Sissi
En raporteer dadelik terug aan my	Ja u Majesteit
u Majesteit	Ja
My gunsteling blomme is rooi rose	Myne ook
Maar laat ons nie oor my praat nie	Nene
Wat sê jy	Ek sal hom laat weet
Wat sê jy	Net soos myne
Watter glimlag	Die glimlag
Prost	Prost
Wat het jy gesê	Ek is woedend
Jy het daarmee baie goed gedoen	Ja
Voorspoed	Voorspoed
Kry dit	Kry die bal
Wat is it	Max
daar is Frankryk Portugal en Spanje ver ver weg	Sien jy
Niks nie	Niks nie
En my deurwag se vrou is voorgestel as ek	
Elke 7 sekondes sterf n Duitse soldaat	Stalingrad massagraf
Aan u almal my innige dank vir al u dienste en wens u alles van die beste vir die toekoms	Dankie generaal
Wagwoord	
Maar maar My Dames	My here
Hart	Hart
Ssst	Leopold
Hallo	
Doktor	Help
Wonderlik 	Dankie
Is ek mooi	Hm
Hier is ek	Ja
Ek ken u is u van die pers	Ja
hoe 	Ag
Bietjie vinniger	Kom
VUUR	Vuur
Het hom	Het hom
Van harte geluk	Dankie
	Vroliker
Vroliker	
Ek voel so verdomp alleen	Iemand wat my altyd sal beskerm
Iemand wat my altyd sal beskerm	Ek voel so verdomp alleen
Chris	Help
Jy kan môre uitpak	Maak gou
Stilte	Haai wat s jou naam
Is dit n hoed op jou kop	Kees
het jy n hoed op	Ciske
Hy sal self kom	Ciske
Help	Help
Jy sal aanmeld na ete	Ja meneer
Moeder moordenaar	Moeder moordenaar
moordenaar	moordenaar
moordenaar	moordenaar
Nee	Maak dit skoon
Maak dit skoon	Nee
Wys dat jy n man is	Ja meneer
Ja	Ja
Ja	Ja
Ja	Ja
Ja	Ja
Goeiemiddag	Goeiemiddag
Die belastings word steeds swaarder	Dit is goed
Hier is alles wat ons het	Moeder
Dit het sy gesê	Moet jou nie oor ons kwel nie
Vlaandere die leeu	Vlaandere die leeu
Dans	Dans
Dans	Dans
Vorentoe	Vorentoe
Die Sjampanje Orlofsky	Ek ken hom nie
Die mooiste meisies volop lag en sing	n Dinee wag vir ons soos nog nooit tevore
Vermaak net vermaak	Hier is die slagspreuk
Hier is die slagspreuk	Vermaak net vermaak
Verskoon my	Kan u Russies praat
Ekskuus	Gesondheid
Dit help ook nie	Gesondheid
Die ooreenkoms is te sterk	Hoe ongalant
Daarom verskoon my dat ek lag	Ja so komies is die saak
Sjampanje die Eerste word hy genoem	Sy majesteit word erken dwarsdeur die land
Sy majesteit word erken dwarsdeur die land	Sjampanje die Eerste word hy genoem
Sjampanje die Eerste word hy genoem	Sy majesteit word erken dwarsdeur die land
Sy majesteit word erken dwarsdeur die land	Sjampanje die Eerste word hy genoem
Sjampanje die Eerste word hy genoem	Sy majesteit word erken dwarsdeur die land
Sy majesteit word erken dwarsdeur die land	Sjampanje die Eerste word hy genoem
Op u gesondheid meneer Markies	Dankie dankie dankie
Gesondheid Kavalier en Markies	Dankie dankie dankie
n byregstand	Wat
Dit lui	Ja
vereis diskresie	Die situasie
Die situasie	vereis diskresie
En Adele	Ek speel saam
Rosie	O
 en orde kom te voorskyn	Wanorde wyk 
Wanorde wyk 	 en orde kom te voorskyn
 na die ewige nag	 in die onderwêreld se diepte af 
 in die onderwêreld se diepte af 	 na die ewige nag
 ontstaan op God se Woord	En n nuwe wêreld 
En n nuwe wêreld 	 ontstaan op God se Woord
in die onderwêreld se diepte af 	 na die ewige nag
 ontstaan op God se Woord	En n nuwe wêreld 
En n nuwe wêreld 	 ontstaan op God se Woord
 beweeg die see heftig	Rollend in skuimende golwe 
Rollend in skuimende golwe 	 beweeg die see heftig
Die bergpieke styg te voorskyn	Heuwels en kranse verskyn
Heuwels en kranse verskyn	Die bergpieke styg te voorskyn
 met vele kronkels	 word deur n brëe stroom deursny 
 word deur n brëe stroom deursny 	 met vele kronkels
 in die stil dal n helder stroom	Sag ruisend gly 
 in die stil dal n helder stroom	Sag ruisend gly 
 n helder stroom	 in die stil dal 
 in die stil dal 	 n helder stroom
Hier spruit genesing uit	Hier adem plante balsem uit
Hier adem plante balsem uit	Hier spruit genesing uit
 pryk aan die firmament	En Sy handewerk 
En Sy handewerk 	 pryk aan die firmament
 lewerik se vrolike lied	 die môre word begroet deur die 
 die môre word begroet deur die 	 lewerik se vrolike lied
 verval hulle in stof	As U die asem wegneem
As U die asem wegneem	 verval hulle in stof
 is U handewerk	Die wêreld so groot so wonderlik
Die wêreld so groot so wonderlik	 is U handewerk
 is U handewerk	Die wêreld so groot so wonderlik
Die wêreld so groot so wonderlik	 is U handewerk
Versprei oral Sy lof 	 in julle koorsang
 heerlike geure vir Hom uit	Plante en blomme adem julle 
Plante en blomme adem julle 	 heerlike geure vir Hom uit
Aarde en hemel aanbid U	Ons prys U in ewigheid
Ons prys U in ewigheid	Aarde en hemel aanbid U
Aarde en hemel aanbid U	Ons prys U in ewigheid
Dierbare man ons samesyn is my lewe	Jou liefde is my loon
Aan jou is my lewe gewy	Met jou is die lewe saligheid
Met jou is die lewe saligheid	Aan jou is my lewe gewy
Aan jou is my lewe gewy	Met jou is die lewe saligheid
Met jou is die lewe saligheid	Aan jou is my lewe gewy
Dankie Ludwig	Geluk
Dankie	Geluk
Veels geluk	Dankie
Ek het vir jou iets gebring	Goed
Goeie nag	Goeie nag
Goeie nag	Goeie nag
n Bietjie harder	So
Ek gee hierdie ring as teken van my trou	Ek gee hierdie ring as teken van my trou
Kom aan	Kom
Wilde dier	Stop
Nee kyk	Carola
Ek sweer	Ek sweer
Ek sweer	Ek sweer
Charles	Charles
Ja gooi Hélène	Welkom
Na die guillotien	Na die guillotien
Volgende week dan	Ja
Ja ek wil	Nee
Ek weet nog nie	En jy
Kyk na daardie	Is jy klaar
Wat	Ek het hom lief
Ja dis so	Is dit wat jy dink
Kan jy dit nie hier doen nie	Om gesuip te raak
meer	Speel iets meer
Speel iets meer	meer
Hoe weet jy hulle het goed gespeel	Die musikante
n sagte sug eggo	En dan
Nee nie altyd nie	Tien frank
Laat ons dorp in vrede	Stop
Samurai	Halt
Brandende vleis	Yakul
Don s doen t draai in n demoon	Okkoto
Waar is jy	San
Ashitaka	San
San	Ashitaka
Ayubowan	
Hoe kan jy weet	Ek weet
Die viool	Ja
Wie is dit	Wie is daar
Chou Yuan	Chou Yuan
Asseblief	Maak oop
Ter wille van my professie	400
Ter wille van my professie	40 floryne
Lotte	Anna
Weet u waar Lotte is	Lotte
Nie genoeg nie	Dis nie genoeg nie
Nooit weer nie	Nooit weer nie
Ek kan dit nie anders stel nie	Ek het my doodgeskrik
Vladimir Semionov	In Grozny
God het ons vir altyd in Christus vergewe	God het ons van die dood gered
Dis ek nie Satan nie	Vat so Satan
Dankie Vader	Ouma
Maar natuurlik	Pepinot
Koeëlkop	Bly stil
Daarom sal hy onpartydig wees om te kies wie eerste gestraf word	Stil
Jy sal nie die rëels hier maak nie	Jy sal nie die rëels hier maak nie
Jy sal nie die rëels hier maak nie	Jy sal nie die rëels hier maak nie
Hulle dra ronde hoede lank lewe Britanny	Hulle dra ronde hoede lank lewe die Bretons
Ons is van Dambodem Dis wat ons pla	Ons is van Dambodem Dis nogal verontrustend
Ons is van Dambodem Dis nogal verontrustend	Ons is van Dambodem Dis wat ons pla
Vertel my	Waar is die geld
Wag vir my	Mnr Mathieu
Christus wees ons genadig	God wees ons genadig
Heer eniggebore Seun Jesus Christus	God die Vader Almagtig
God die Vader Almagtig	Heer eniggebore Seun Jesus Christus
Want U alleen is heilig U alleen is Here	U alleen is die Allerhoogste Jesus Christus
Gesëend hy wat kom in die Naam van die Here	Hosanna in die hoogste
Gee nou oor aan die oorwinnaar	Jy kan my nie ontglip nie
30	Nee
Bring dit na jou lippe toe	Goed
en drink	Goed
Uitstekend	Uitstekend
Ses dae	Ek is so gelukkig
Verskoon hom hy is kinderagtig	Weg is jy
Hy s onbesonne	Weg is jy
onvolwasse	Weg is jy
Hy laat mens lag	Hy raak van sy verstand af
Hy raak van sy verstand af	Hy laat mens lag
Hy laat mens lag	Hy raak van sy verstand af
Doktor Dulcamara is n kenner op elke gebied	Die mees ervare sanger sou nie beter gekies het nie
Kan jy my sê watter letters daar staan	Ja
Vertraagde	Kyk waar jy loop
Kyk waar jy loop	Vertraagde
Loser	Luis
Luis	Loser
Verdomp	Verdomp
Verdomp	Verdomp
Kyk na jou	Is alles reg
Dit gaan goed	Alles gaan goed
Ek moet	Moenie gaan nie
Rapporteer volgens voorskrif	Vuur die sein af
Kool	Nee
Weg met die Muur	Weg met die Muur
Weg met die Muur	Weg met die Muur
Ek wen ek wen na na na	Ja
Anne kom hier	Anne
Hoekom	Kyk my in die oë
Ek is nie bang nie	Ek is nie bang nie
Ek is nie bang nie	Ek is nie bang nie
Ek is nie bang nie	Ek is nie bang nie
Ek is nie bang nie	Ek is nie bang nie
Ek is nie bang nie	Ek is nie bang nie
Ek is nie bang nie	Ek is nie bang nie
Dit sou julle nie kon dink nie	Guy de Maupassant
Wat	Hier sit iemand
Preie	Preie
Anete	Anete
Laat los my	Los my
Wat ek daagliks vir my dogter Lieschen sȇ is totaal vrugteloos	Het mens nie van sy kinders honderduisend beproewinge nie
As iemand my wil trakteer skink dan vir my koffie in	Koffie koffie moet ek hȇ
Koffie koffie moet ek hȇ	As iemand my wil trakteer skink dan vir my koffie in
Nou hoe kan mens die dogters belet	Die ma s is versot op koffie en die oumas drink ook
Die ma s is versot op koffie en die oumas drink ook	Nou hoe kan mens die dogters belet
	Jammer
Hoe s daai vir jou	
is jy hier	
Maestro	Musiek
Pu	Pustë
Wat is dit	Heil Hitler
Of hier	Hier
Dis wat ek gedink het die eerste keer toe ek jou gesien het	Songod
Bon appetit	Bon appetit
Bon appetit	Bon appetit
kan jy regop sit	Stella
by die kliniek	Ja
Barbara	Los my
Angie het vir jou kom kuier	Ja
Dit was te veel	Dis goed so dis wat ek wil hê
Jy wil nie	Nee
Wat	63
Wil jy bly	Ja
Speel jy moeder	Wat gaan aan
Lees dit noukeurig	Ondeund
Wou jy nie verder studeer nie	Nee
Los my	Baptiste
Tony wakker word	Tony
Verdorie	Ziva
Op die oomblik jy	Ziva
Tony wakker word	Tony
Verdorie	Ziva
Op die oomblik jy	Ziva
Gaan voort	Dankie
Nee	Nee
Gaan voort	Dankie
Nee	Nee
Dit is die vrou van Marv	Jonah
Dit is die vrou van Marv	Jonah
Ek kry terug wat julle van ons gesteel het	Ek sal hom vind
Ek sal hom vind Lara	Ek sal hom vind
Rustig	Rustig
Soek dekking	Soek dekking
Nee mam	Jonathan
Julle is nie alleen nie	Julle is nie alleen nie
Ek herhaal	Guardian neergestort het
Dit is daar nie veilig nie	Miss Lane
JOOD	JOOD
Gee my dan iets	Ja
In die nag ook	Ja
Liewenheersbesie	Motschekiebchen
Motschekiebchen	Liewenheersbesie
As jy nou huistoe gaan sal jy hom sien	
Sal hy kom	
Line bly by my	Line
Wil jy die kind hê	Ja
Nee jy weet nie	Ja ek weet
Wat sê jy	Wat moet ek doen
Antwoord my	Waar was jy
Dis uiters belangrik	Kry die oorhand
Ja	Komaan Beaulieu
Gooi weg ons benodig nie hulle goed nie	Lamsbredie
Kanada	Kanada
Kanada	Kanada
Ek kan ruik jy was by die koeie	Is nie
Wees gehoorsaam	Ja
Toe het sy jou vader vir die eerste keer gesien	Ja
Tante	Ja
Wat sê jy rot	Dis gemors
Die verraaiers bly lewe hulle sluit Wałęsa hulle koop Kułaj	Ons het n oorlog
Dankie 1971	Veels geluk
Dankie	Veels geluk
Wie het jou dit geleer	
Die mas moet oorboord	Kap af
Ons moet in lyn bly	Twee streke na bakboord
Hoera	Hoera
Vier streke na stuurboord	Kom om
Op ons dis veel beter	Op ons
Nee	Nie sleg vir ons nie
U sal met u eie gewete moet lewe	Hoe durf u
Gelyk	Haal op
Haal op	Gelyk
Heidi	Ja
O Vader	Sebastian
Goeiedag	Goeiedag
Bed toe	Nag
Dankie	Dag
Slaap lekker	Slaap lekker
Ons is nie bedrieërs mevrou	Wat dink u
Nee dit is te laat	Nog n halfuurtjie
Kan jy al swem	Ja
Is jy seker	Ja
Ja	Ek ook
Professioneel	Op die pous
Ek	Ja
Teen die muur	Ja
Broodroof	Vuile brakke
Mag ek n woordjie verduideliking gee oor die waterversagter	Nee
Rob	Aangenaam
Laat hom nie op my tone val nie	Ja
